+-+-+-+-+-+-+-+-+-+-+-+-+-+-+-+
|     | | | |   | | | |   |   |
+ + + + + + + + + + + + +-+ + +
| | | | |   | |     |   |   | |
+-+-+ + +-+ + +-+-+-+-+ +-+ + +
| | | | |   | | |     | | | | |
+ + + + +-+ + + + + + + + +-+ +
|   |       |   | | | | | | | |
+ + +-+-+ + +-+ +-+ + + + + + +
| |   | | |   | | | |     |   |
+-+-+ + +-+ + + + +-+-+ + +-+ +
| | | |     | |   | | | | |   |
+ + + +-+-+-+ +-+ + + +-+ +-+ +
|   | | |     |     | |   |   |
+ + + + +-+ + + + +-+ + + +-+ +
| | | | | | |   |   | | | |   |
+ + + + + + +-+ +-+-+ +-+ +-+ +
| |     | | | |   |   | | | | |
+-+-+-+ + + + + + + + + + + + +
| |   | |   | | | | | | | |   |
+ +-+ + +-+ + + +-+ + + + +-+ +
|       | | | |   | | |   |   |
+-+-+-+ + + + + +-+-+ +-+ + + +
|   | | |     | |     | |   | |
+-+ + + + + +-+ + + +-+ +-+-+ +
|       | |   |   | | | |     |
+ + +-+ + + +-+ + + + + +-+-+ +
| |   |   | | | | |   |       |
+-+-+-+-+-+ + + + + +-+-+-+ +-+
|             | | |           |
+-+-+-+-+-+-+-+-+-+-+-+-+-+-+-+
