+-+-+-+-+-+-+-+-+-+-+-+-+-+-+-+
| |   |   |   |     | |       |
+ + +-+ + + +-+-+-+ + + + +-+ +
| | | | | |       | |   |   | |
+ + + +-+ + +-+-+-+ + +-+-+ +-+
|   |     |   |     |     |   |
+ + + +-+-+ + +-+ + + + + + + +
| | |     | | |   |   | | | | |
+ + +-+-+ +-+ + + +-+-+-+-+ + +
| |           | | |   | |   | |
+ +-+ + + +-+-+ +-+-+ + +-+ +-+
| | | | |             |       |
+ + + + +-+ + + +-+ +-+ +-+ +-+
| | | | |   | | |   | | | |   |
+ + +-+ +-+-+-+ + +-+ + + + +-+
|   | | | | |   |     | |     |
+-+ + + + + + + +-+-+ +-+ +-+ +
| |   |   |   | | | | | | | | |
+ + +-+-+-+ +-+-+ + + + + + + +
| |   |     |         |   | | |
+ + + +-+-+ + +-+ +-+-+-+ + + +
|   |   |   | | | | |       | |
+ +-+-+-+ +-+-+ + + +-+-+ + +-+
| | | |         | | |     |   |
+ + + + +-+ +-+ + + + + + +-+ +
|   |   | |   | | |   | | |   |
+ +-+ +-+ +-+ +-+ + + + + + +-+
| |       |   |   | | | | | | |
+ +-+-+ +-+ + +-+-+ +-+-+ +-+ +
|     |   | |     |     |     |
+-+-+-+-+-+-+-+-+-+-+-+-+-+-+-+
